expFromLvl=100
goldFromLvl=1000
startEnegryPercent=1.0f
startHpPercent=1.0f
mapType=time
timeLimit=240
mapSize=24:14
blocks=\
  3     -3              -3     -3     -3     -3         -3     -3           -3         -3     -3          -3          -3     -3     -3          -3     -3           -3     -3     -3          -3     -3     -3     -3/\
  3     -60:1:1:5:1     -18    -18    -18    -60:0:1:1:1-3     -3           -3         -3     -3          -3          -3     -3     -3          -3     -3           -3     -3     -3          -3     -3     -3     -3/\
  3     -3              -3     -3     -3     -3         -3     -3           -60:3:1:8:6-3     -3          -3          -3     -3     -3          -3     -3           -3     -3     -3          -3     -3     -3     -3/\
  3     -3              -3     -3     -3     -3         -3     -3           -18        -3     -3          -3          -3     -3     -3          -3     -3           -3     -3     -60:3:1:19:7-3     -3     -3     -3/\
  3     -3              -3     -3     -3     -3         -3     -3           -18        -3     -60:1:1:14:4-18         -18    -18    -60:0:1:10:4-3     -3           -3     -3     -18         -3     -3     -3     -3/\
  3     -3              -3     -3     -3     -3         -3     -3           -18        -3     -3          -3          -3     -3     -3          -3     -3           -3     -3     -18         -3     -3     -3     -3/\
  3     -3              -3     -3     -3     -3         -3     -3           -60:2:1:8:2-3     -3          -3          -3     -3     -3          -3     -3           -3     -3     -18         -3     -3     -3     -3/\
  3     -60:3:1:1:11    -3     -3     -3     -3         -3     -3           -3         -3     -3          -3          -3     -3     -3          -3     -60:3:1:16:11-3     -3     -60:2:1:19:3-3     -3     -3     -3/\
  3     -18             -3     -3     -3     -3         -3     -3           -3         -3     -3          -3          -3     -3     -3          -3     -18          -3     -3     -3          -3     -3     -3     -3/\
  3     -18             -3     -3     -3     -3         -3     -3           -3         -3     -3          -3          -3     -3     -3          -3     -18          -3     -3     -3          -3     -3     -3     -3/\
  3     -18             -3     -3     -3     -3         -3     -3           -3         -3     -3          -3          -3     -3     -3          -3     -18          -3     -3     -3          -3     -3     -3     -3/\
  3     -80:0z60:2:1:1:7-3     -3     -3     -3         -3     -60:1:1:11:11-18        -18    -18         -60:0:1:7:11-3     -3     -3          -3     -60:2:1:16:7 -3     -3     -3          -3     -3     -3     -3/\
  3     -3              -3     -3     -3     -3         -3     -3           -3         -3     -3          -3          -3     -3     -3          -3     -3           -3     -3     -3          -3     -3     -3     -3/\
  3     -3              -3     -3     -3     -3         -3     -3           -3         -3     -3          -3          -3     -3     -3          -3     -3           -3     -3     -3          -3     -3     -3     -3/
waves=\
  16:1:1.5f:15/
drop=4:2/3:2/6:2
penaltyDrop=6:1