expFromLvl=40
goldFromLvl=200
startEnegryPercent=1.0f
startHpPercent=1.0f
mapType=standart
mapSize=24:14
blocks=\
  0     -0     -0     -0     -0     -0     -0     -0     -0     -0     -0     -0     -0     -0     -0     -0     -0     -0     -0     -0     -0     -0     -0     -0/\
  0     -0     -21:1:0-18    -18    -18    -21:3:0-0     -0     -0     -21:1:0-18    -18    -21:3:0-0     -0     -0     -21:1:0-18    -18    -18    -21:3:0-0     -0/\
  0     -0     -18    -0     -0     -0     -18    -0     -0     -0     -18    -0     -0     -18    -0     -0     -0     -18    -0     -0     -0     -18    -0     -0/\
  0     -0     -18    -0     -0     -0     -21:1:0-18    -18    -18    -21:2:0-0     -0     -21:1:0-18    -18    -18    -21:2:0-0     -0     -0     -18    -0     -0/\
  0     -0     -18    -0     -0     -0     -0     -0     -0     -0     -0     -0     -0     -0     -0     -0     -0     -0     -0     -0     -0     -18    -0     -0/\
  0     -0     -18    -0     -21:1:0-18    -18    -18    -18    -18    -18    -18    -18    -18    -18    -21:3:0-0     -21:3:0-18    -18    -18    -21:0:0-0     -0/\
  0     -0     -18    -0     -18    -0     -0     -0     -0     -0     -0     -0     -0     -0     -0     -18    -0     -18    -0     -0     -0     -0     -0     -0/\
  0     -0     -18    -0     -21:2:0-18    -18    -18    -21:0:0-0     -21:1:0-18    -99    -0     -0     -18    -0     -18    -0     -0     -0     -0     -0     -0/\
  0     -0     -18    -0     -0     -0     -0     -0     -18    -0     -18    -0     -0     -0     -0     -18    -0     -18    -0     -0     -0     -0     -0     -0/\
  0     -0     -18    -0     -21:1:0-18    -18    -18    -21:2:0-0     -21:2:0-18    -18    -18    -18    -21:0:0-0     -21:1:0-18    -18    -18    -21:3:0-0     -0/\
  0     -0     -18    -0     -18    -0     -0     -0     -0     -0     -0     -0     -0     -0     -0     -0     -0     -0     -0     -0     -0     -18    -0     -0/\
  0     -0     -18    -0     -21:2:0-18    -18    -18    -18    -18    -18    -18    -18    -18    -18    -18    -18    -18    -18    -18    -18    -21:0:0-0     -0/\
  0     -0     -18    -0     -0     -0     -0     -0     -0     -0     -0     -0     -0     -0     -0     -0     -0     -0     -0     -0     -0     -0     -0     -0/\
  0     -0     -80:2:0-0     -0     -0     -0     -0     -0     -0     -0     -0     -0     -0     -0     -0     -0     -0     -0     -0     -0     -0     -0     -0/
waves=\
  4:1:1f:50/
drop=150:1:1f
penaltyDrop=1:1:0.5f/2:1:0.5f/3:1:0.5f