expFromLvl=20
goldFromLvl=75
startEnegryPercent=0.5f
startHpPercent=1.0f
mapType=standart
mapSize=20:12
blocks=\
  0     -0     -0     -0     -0     -0     -0     -0     -0     -0     -0     -0     -0     -0     -0     -0     -0     -0     -0     -0/\
  0     -0     -0     -0     -0     -0     -0     -0     -0     -0     -0     -0     -0     -0     -0     -0     -0     -0     -0     -0/\
  0     -0     -0     -0     -0     -0     -0     -0     -0     -0     -0     -0     -0     -0     -0     -0     -0     -0     -0     -0/\
  0     -0     -21:1:0-18    -18    -21:3:0-0     -0     -21:1:0-18    -18    -18    -18    -18    -18    -21:3:0-0     -0     -0     -0/\
  0     -0     -18    -0     -0     -18    -0     -0     -18    -0     -0     -0     -0     -0     -0     -18    -0     -0     -0     -0/\
  0     -0     -18    -0     -0     -18    -0     -0     -18    -0     -0     -0     -0     -0     -0     -18    -0     -0     -0     -0/\
  80:1:2-18    -21:2:0-0     -0     -18    -0     -0     -18    -0     -0     -0     -0     -0     -0     -18    -0     -0     -0     -0/\
  0     -0     -0     -0     -0     -18    -0     -0     -18    -0     -0     -0     -0     -0     -0     -18    -0     -0     -0     -0/\
  0     -0     -0     -0     -0     -21:1:0-18    -18    -21:2:0-0     -0     -0     -21:3:0-18    -18    -21:0:0-0     -0     -0     -0/\
  0     -0     -0     -0     -0     -0     -0     -0     -0     -0     -0     -0     -18    -0     -0     -0     -0     -0     -0     -0/\
  0     -0     -0     -0     -0     -0     -0     -0     -0     -0     -0     -0     -18    -0     -0     -0     -0     -0     -0     -0/\
  0     -0     -0     -0     -0     -0     -0     -0     -0     -0     -0     -0     -99    -0     -0     -0     -0     -0     -0     -0
waves=\
  1:3:1.2f:20/\
  0:5:1.5f:5/\
  1:5:1.0f:5/\
  1:15:1.5f:5/\
  0:20:1.0f:10/
drop=1:1:0.7f/2:1:0.7f/3:1:0.7f
penaltyDrop=2:1:0.5f