expFromLvl=25
goldFromLvl=100
startEnegryPercent=0.5f
startHpPercent=1.0f
buildType=standart
mapSize=20:12
blocks=\
  0     -0     -0     -0     -0     -0     -0     -0     -0     -0     -0     -0     -0     -0     -0     -0     -0     -0     -0     -0/\
  0     -0     -0     -0     -0     -0     -0     -0     -0     -0     -0     -0     -0     -0     -0     -0     -0     -0     -0     -0/\
  0     -0     -0     -21:1:0-18    -18    -18    -18    -18    -18    -18    -18    -18    -21:3:0-0     -0     -0     -0     -0     -0/\
  0     -0     -0     -18    -0     -0     -0     -0     -0     -0     -0     -0     -0     -18    -0     -0     -0     -0     -0     -0/\
  0     -0     -0     -18    -0     -0     -0     -0     -0     -0     -0     -0     -0     -21:1:0-18    -18    -18    -21:3:0-0     -0/\
  0     -0     -0     -18    -0     -0     -0     -0     -0     -0     -0     -0     -0     -0     -0     -0     -0     -18    -0     -0/\
  0     -0     -0     -18    -0     -0     -0     -0     -0     -0     -0     -0     -0     -0     -0     -0     -0     -18    -0     -0/\
  0     -0     -0     -21:2:0-18    -18    -18    -18    -21:0:0-0     -0     -0     -0     -0     -0     -0     -0     -18    -0     -0/\
  0     -0     -0     -0     -0     -0     -0     -0     -18    -0     -0     -0     -0     -0     -0     -0     -0     -18    -0     -0/\
  0     -0     -0     -0     -0     -0     -0     -0     -18    -0     -0     -0     -21:3:0-18    -18    -18    -18    -21:0:0-0     -0/\
  0     -0     -0     -0     -0     -0     -0     -0     -18    -0     -0     -0     -18    -0     -0     -0     -0     -0     -0     -0/\
  0     -0     -0     -0     -0     -0     -0     -0     -80:2:0-0     -0     -0     -99    -0     -0     -0     -0     -0     -0     -0/
waves=\
  0:3:1.5f:20/\
  1:3:2.0f:7/\
  0:7:1.7f:7/\
  2:5:1.8f:7/\
  0:10:1.8f:7/\
  2:7:1.5f:7/\
  4:2:3.0f:10
drop=3:1-3
penaltyDrop=2:3:0.1f