expFromLvl=35
goldFromLvl=150
startEnegryPercent=0.5f
startHpPercent=1.0f
mapType=standart
mapSize=20:12
blocks=\
  0      -0     -0     -0     -0     -0     -0     -0     -0     -0     -0     -0     -0     -0     -0     -0     -0     -0     -0     -0/\
  0      -0     -0     -0     -0     -0     -0     -0     -0     -0     -0     -0     -0     -0     -0     -0     -0     -0     -0     -0/\
  0      -0     -0     -21:3:0-18    -18    -18    -18    -18    -18    -21:0:0-0     -0     -0     -0     -0     -0     -0     -0     -0/\
  0      -0     -0     -18    -0     -0     -0     -0     -0     -0     -18    -0     -0     -0     -0     -0     -21:3:0-18    -18    -80:0:0/\
  0      -0     -0     -18    -0     -0     -0     -0     -0     -0     -18    -0     -0     -0     -0     -0     -18    -0     -0     -0/\
  99     -18    -18    -21:0:0-0     -0     -0     -0     -0     -0     -18    -0     -0     -0     -0     -0     -18    -0     -0     -0/\
  0      -0     -0     -0     -0     -0     -0     -21:1:0-18    -18    -21:2:0-0     -0     -0     -0     -0     -18    -0     -0     -0/\
  0      -0     -0     -0     -0     -0     -0     -18    -0     -0     -0     -0     -0     -0     -0     -0     -21:1:0-18    -21:3:0-0/\
  0      -0     -0     -0     -0     -0     -0     -18    -0     -0     -0     -0     -0     -0     -0     -0     -0     -0     -18    -0/\
  0      -0     -0     -0     -0     -0     -0     -18    -0     -0     -0     -0     -0     -0     -0     -0     -0     -0     -18    -0/\
  0      -0     -0     -0     -0     -0     -0     -21:2:0-18    -18    -18    -18    -18    -18    -18    -18    -18    -18    -21:0:0-0/\
  0      -0     -0     -0     -0     -0     -0     -0     -0     -0     -0     -0     -0     -0     -0     -0     -0     -0     -0     -0/
waves=\
  1:6:1.4f:10/\
  0:5:1.7f:7/\
  3:7:2.0f:7/\
  4:3:1.8f:7/\
  3:10:1.2f:7/\
  2:12:1.5f:7/\
  3:15:1.0f:10
drop=2:1:0.5f/1:1-3/
penaltyDrop=2:2:1f