expFromLvl=35
goldFromLvl=180
startEnegryPercent=0.5f
startHpPercent=1.0f
mapType=standart
mapSize=24:14
blocks=\
  0      -0     -0     -0     -0     -0     -0     -0     -0     -0     -0     -0     -0     -0     -0     -0     -0     -0     -0     -0     -0     -0     -0     -0/\
  0      -0     -0     -0     -0     -0     -0     -0     -0     -0     -0     -0     -0     -0     -0     -0     -0     -0     -0     -0     -0     -0     -0     -0/\
  0      -0     -0     -0     -0     -0     -0     -0     -0     -0     -0     -0     -0     -0     -0     -0     -0     -0     -0     -0     -0     -0     -0     -0/\
  0      -0     -0     -0     -0     -21:3:0-18    -18    -18    -18    -18    -18    -18    -21:0:0-0     -0     -0     -0     -0     -0     -0     -0     -0     -0/\
  0      -0     -0     -0     -0     -18    -0     -0     -0     -0     -0     -0     -0     -18    -0     -0     -0     -0     -0     -0     -21:3:0-18    -18    -80:0:0/\
  0      -0     -0     -0     -0     -18    -0     -0     -0     -0     -0     -0     -0     -18    -0     -0     -0     -0     -0     -0     -18    -0     -0     -0/\
  99     -18    -18    -18    -18    -21:0:0-0     -0     -0     -0     -0     -0     -0     -18    -0     -0     -0     -0     -0     -0     -18    -0     -0     -0/\
  0      -0     -0     -0     -0     -0     -0     -0     -0     -0     -21:1:0-18    -18    -21:2:0-0     -0     -0     -0     -0     -0     -18    -0     -0     -0/\
  0      -0     -0     -0     -0     -0     -0     -0     -0     -0     -18    -0     -0     -0     -0     -0     -0     -0     -0     -0     -21:1:0-18    -21:3:0-0/\
  0      -0     -0     -0     -0     -0     -0     -0     -0     -0     -18    -0     -0     -0     -0     -0     -0     -0     -0     -0     -0     -0     -18    -0/\
  0      -0     -0     -0     -0     -0     -0     -0     -0     -0     -18    -0     -0     -0     -0     -0     -0     -0     -0     -0     -0     -0     -18    -0/\
  0      -0     -0     -0     -0     -0     -0     -0     -0     -0     -18    -0     -0     -0     -0     -0     -0     -0     -0     -0     -0     -0     -18    -0/\
  0      -0     -0     -0     -0     -0     -0     -0     -0     -0     -21:2:0-18    -18    -18    -18    -18    -18    -18    -18    -18    -18    -18    -21:0:0-0/\
  0      -0     -0     -0     -0     -0     -0     -0     -0     -0     -0     -0     -0     -0     -0     -0     -0     -0     -0     -0     -0     -0     -0     -0/
waves=\
  1:8:1.4f:10/\
  0:9:1.7f:7/\
  3:7:2.4f:7/\
  2:6:1.1f:7/\
  3:10:1.2f:7/\
  2:12:0.8f:7/\
  3:10:1.0f:10
drop=1:1/3:1:0.5f/
penaltyDrop=1:1:0.3f/2:1:0.3f