expFromLvl=35
goldFromLvl=180
startEnegryPercent=0.5f
startHpPercent=1.0f
mapType=standart
mapSize=24:14
blocks=\
  1      -1      -1     -1     -1     -1     -1     -1     -1     -1     -1     -1     -1     -1     -1      -1     -1      -1     -1     -1     -1     -1     -1     -1/\
  80:1:0 -18     -18    -18    -18    -18    -18    -18    -18    -18    -18    -18    -18    -21:3:0-1      -1     -1      -1     -1     -1     -1     -1     -1     -1/\
  1      -1      -1     -1     -1     -1     -1     -1     -1     -1     -1     -1     -1     -18    -1      -1     -1      -1     -1     -1     -1     -1     -1     -1/\
  1      -1      -1     -1     -1     -1     -1     -1     -1     -1     -1     -1     -1     -18    -1      -1     -1      -1     -21:1:0-18    -18    -18    -18    -99/\
  1      -1      -1     -1     -1     -1     -1     -1     -1     -1     -1     -1     -1     -18    -1      -1     -1      -1     -18    -1     -1     -1     -1     -1/\
  80:1:0 -18     -18    -18    -18    -18    -18    -18    -18    -18    -18    -18    -18    -21:3:0-1      -1     -1      -1     -21:2:0-18    -21:0:0-1     -1     -1/\
  1      -1      -1     -1     -1     -1     -1     -1     -1     -1     -1     -1     -1     -18    -1      -1     -1      -1     -1     -1     -18    -1     -1     -1/\
  1      -1      -1     -1     -1     -1     -1     -1     -1     -1     -1     -1     -1     -18    -1      -1     -1      -1     -1     -1     -18    -1     -1     -1/\
  1      -1      -1     -1     -1     -1     -1     -1     -1     -1     -1     -1     -1     -18    -1      -1     -1      -1     -1     -1     -18    -1     -1     -1/\
  80:1:0 -18     -18    -18    -18    -18    -18    -18    -18    -18    -18    -18    -18    -21:1:0-18     -18    -18     -18    -18    -18    -21:2:0-1     -1     -1/\
  1      -1      -1     -1     -1     -1     -1     -1     -1     -1     -1     -1     -1     -1     -1      -1     -1      -1     -1     -1     -1     -1     -1     -1/\
  1      -1      -1     -1     -1     -1     -1     -1     -1     -1     -1     -1     -1     -1     -1      -1     -1      -1     -1     -1     -1     -1     -1     -1/\
  1      -1      -1     -1     -1     -1     -1     -1     -1     -1     -1     -1     -1     -1     -1      -1     -1      -1     -1     -1     -1     -1     -1     -1/\
  1      -1      -1     -1     -1     -1     -1     -1     -1     -1     -1     -1     -1     -1     -1      -1     -1      -1     -1     -1     -1     -1     -1     -1/
waves=\
  6:4:2.0f:10/\
  5:3:1.5f:0/\
  5:3:1.5f:0/\
  5:6:1.2f:10/\
  5:6:1.2f:0/\
  6:3:1.5f:0/\
  5:8:0.2f:10/\
  6:3:1.0f:0/\
  6:3:1.2f:0/\
  5:7:0.6f:10/\
  5:7:0.7f:0/\
  7:1:1.1f:0/
drop=1:1-2/2:2:0.4f/5:1/
penaltyDrop=1:1:0.8f/5:1:0.2f